	G20 Information Centre
provided by the G20 Research Group	


G20 Summits |  G20 Ministerials |  G20 Analysis |  Search |  About the G20 Research Group
[English]  [Français]  [Deutsch]  [Italiano]  [Portuguesa]  [Japanese]  [Chinese]  [Korean]  [Indonesian]

 



G20 Summits • G20 Ministerial and Deputies Meetings

2024 Rio de Janeiro Summit

November 18-19, 2024

See also
Road to the 2024 Rio Summit | Analysis by the G20 Research Group | Brazil's G20 presidency website

Official documents released at the 2024 Rio Summit will be published here when they become available.

Summit: November 18-19, 2024

G20 Rio de Janeiro Leaders' Declaration, November 18, 2024

Concept Note, produced by Brazil's G20 Presidency

The G20 Summit has defined its agenda; the focus will be on social inclusion, global reform, and sustainability, Brazil's G20 Presidency, November 9, 2024

Social Summit: November 14-16, 2024
Participating Countries
Argentina: Javier Milei, President
Australia: Anthony Albanese, Prime Minister
Brazil: Luiz Inácio Lula da Silva, President
Canada: Justin Trudeau, Prime Minister
China: Xi Jinping, President
France: Emmanuel Macron, President
Germany: Olaf Scholz, Chancellor
India: Narendra Modi, Prime Minister
Indonesia: Prabowo Subianto, President
Italy: Giorgia Meloni, Prime Minister
Japan: Shigeru Ishiba, Prime Minister
Korea: Yoon Suk-yeol, President
Mexico: Claudia Sheinbaum, President
Russia: Sergey Lavrov, Minister of Foreign Affairs
Saudi Arabia: Faisal bin Farhan Al Saud, Minister of Foreign Affairs
South Africa: Cyril Ramaphosa, President
Türkiye: Recep Tayyip Erdogan, President
United Kingdom: Keir Starmer, Prime Minister
United States: Joe Biden, President
African Union: Mohamed Ould Cheikh El Ghazouani, President
European Union: Charles Michel, President of the European Council
European Union: Ursula von der Leyen, President of the European Commission
Guest Leaders
Angola: João Lourenço, President
Bolivia: Luis Arce, President
Chile: Gabriel Boric, President
Colombia: Gustavo Petro, President
Egypt: Abdel Fattah el-Sisi, President
Malaysia: Anwar Ibrahim, Prime Minister
Norway: Jonas Gahr Støre, Prime Minister
Vatican: Pietro Parolin (Cardeal e SecretÃ¡rio de Estado)
Nigeria: Bola Tinubu, President
Paraguay: Santiago Peña, President
Portugal: Luís Montenegro, Prime Minister
Singapore: Lawrence Wong, Prime Minister
Spain: Pedro Sánchez, President
Tanzania: Samia Suluhu Hassan, President
Qatar: Tamim bin Hamad Al Thani, Emir
Vietnam: Pham Minh Chinh, Prime Minister
United Arab Emirates: Mohammed bin Zayed Al Nahyan, Crown Prince of Abu Dhabi
Uruguay: Omar Paganini, Minister of Foreign Affairs
International Organizations
African Development Bank: Akinwumi Adesina, President
Asian Infrastructure Investment Bank: Jin Liqun, President
Development Bank of Latin America and Caribbean (CAF): Sergio DÃ­az-Granados, Executive President
Financial Stability Board: Klaas Knot, President
Food and Agriculture Organization: Qu Dongyu, Director-General
Inter-American Development Bank: Ilan Goldfajn, President
International Labour Organization: Gilbert Houngbo, Director-General
International Monetary Fund: Kristalina Georgieva, Director-General
League of Arab States: Ahmed Aboul Gheit, Secretary Genearl
New Development Bank: Dilma Rousseff, President
UNESCO: Audrey Azoulay, Director-General
United Nations Conference on Trade and Development (UNCTAD): Rebeca Grynspan, Secretary-General
United Nations: António Guterres, Secretary-General
World Bank: Ajay Banga, President
World Health Organization: Tedros Adhanom Ghebreyesus, Director-General
World Trade Organization: Ngozi Okonjo-Iweala, Secretary-General

[back to top]

[back to top]

This Information System is provided by the University of Toronto Library
and the G20 Research Group at the University of Toronto.

Please send comments to: g20@utoronto.ca
This page was last updated December 09, 2024

	    		    		    	

All contents copyright © 2025. University of Toronto unless otherwise stated. All rights reserved.
 
 
 ----- 
 Source link : https://g20.utoronto.ca/summits/2024rio.html 
 ----- 
